R 800 600
NO ./textures/no_1.xpm
SO ./textures/so.xpm
WE ./textures/textt.xpm
EA ./textures/ea.xpm
S ./textures/chaton.xpm
F 220,145,189
C 175,100,57

1111111111111111111111111
1000000000110000000000001
1011000001110000002000001
1001000000000000000000001
111111111011000001110000000000001
100000000011000001110111111111111
11110111111111011100000002001
11110111111111011101010010001
11000000110101011100000010001
10002000000000001100000010001
10000000000000001101010010001
11000001110101011111011110N1111
11110111 1110101 101111010001
11110111 1110101 101111010001
11111111 1111111 111111111111
