R 800 600
NO ./textures/no_1.xpm
SO ./textures/no_1.xpm
WE ./textures/no_1.xpm
EA ./textures/no_1.xpm
S ./textures/chaton.xpm
F 220,145,189
C 175,100,57

1111111111111111111111111
1000000000110000000000001
101100000111000000200000111111111
100100000000000000111111111110111
111111111011000001110000000000201
100000000011000001110111110111111
11110111111111011100000010001
11110111111111011101010010001
11000000110101011100000010011
10002000000000001100000010001
10000000000000001101010010011
11000001110101011111011110N0111
11110111 1110101 101111010001
11111111 1111111 111111111111