 R   1320      180
NO ./path_to_the_north_texture
SO ./path_to_the_south_texture
WE ./path_to_the_west_texture
 EA  ./path_to_the_east_texture
S ./path_to_the_sprite_texture
F 25,100,6
C  225,30,0           

11111111111111111111111111111111111
11000000000000001111
10000000000200000E1111111111111111
1111111111111111111111111111
