NO ./textures/no_1.xpm
SO ./textures/so.xpm
WE ./textures/ea.xpm
EA ./textures/textt.xpm
S ./textures/chaton.xpm
F 220,145,18
C 17,100,57
R 800 600
1111
1021
12N1
1221
1111