NO ./textures/no_1.xpm
SO ./textures/so.xpm
WE ./textures/ea.xpm
EA ./textures/textt.xpm
S ./textures/chaton.xpm
F 148,252,9
C 244,5,132 
R 1200  1000


1111111111111111111111111
10020110100000000000000001
1000000000000200002000001
10010000012200000000000001
1000200000000020002000001
1010000N00000000000000001
1111111111111111111111111
