NO ./textures/no_1.xpm
SO ./textures/so.xpm
WE ./textures/ea.xpm
EA ./textures/textt.xpm
S ./textures/chaton.xpm
F 220,145,18
C 17,100,57
R 800 600


111111111111111111111111111
111201111000000011100001111111
11121111100000S000001111111
111211111000000000001111111
11111111111112202211111111111
11111111112222202222222111111111
111211111000000020022000001111111
11121111100000000200000001111111
1111111111111101011111111111111
1111111100000000000001111111 
1111111111111111111111111111