R 800 800
NO ./textures/no_1.xpm
SO ./textures/ea.xpm
WE ./textures/textt.xpm
EA ./textures/IMG_1167.xpm
S ./textures/chaton.xpm
F 220,145,189
C 175,100,57

111111111111111111111111111
111201111000002011100001111111
11121111100002S200001111111
111211111000002000001111111
11111111111112222211111111111
111111111122222222222222111111111
111211111000000020022000001111111
11121111100000000200000001111111
1111111111111101011111111111111
11111111000000000000011111111 
111111111111111111111111111
